005000000000004900420002000000000003000
005003000002020900200000000001000000000
005210004000000902040000000030000000000
006000002102000900004102000000000001010
005021020002200900000102000000000000100
007100100000202900000004300100000000000
007000100000224090000004000000000000300
007000000300040900002002200000010300000
008001040000002902000000100200300000100
007030000002104900420000000020000003000
009100020004000900004000000003000000100
007003000000410290000020020001000000000
007100100000202090000004300100000100000
006022010200000009020000400100010010000
007000010000104300900010000020300001010
006000040300000009000040210000000000300
009010040201000090000004010000000000000
007000000010040902000100000020000003000
008000002004200900004000000001000000300
007010400010002090000100002203000000300
009002420100000900000430000000000001000
008000004230020009000040210200000003000
009101042100200090000041000000000003000
011101020010200900004000100022100000300
009000400000000090002230000002010000300
010000000210004090400300000002000000100
010000040000400090000102000200300003000
008000404300020902000400000000000000300
010000044021000009000004210000000000000
008000210000002090440000004000000030000
009001000000000902400100002020000003000
008220300004010900000000024000000300000
008400400000000090000102000020000003000
009220040000002009000010200002010000300
010010300200004000900300000002010000300
008000044010000049000002000000010000000
008201000000040090200004000000100000000
009000104400240090000000000002100000010
008000040010200900002002100000000000300
007030000000002090040000400002000000010
009000100203004090240000000021000000300
008000100100200090042041000000000003000
010000104004200900000000010003000000000
009003002002400900000410000003000001000
009000004000100009020004000000210000000
008021000000004009000002400000010100000
010403004020020009000000410000000000000
008000400010020900004403000003000000000
008020300000000904000100004000000030000
009001020300400900000010000202100000300
010300000002402900020400000003000000100
009001000004002900000200002003000100000
008000004203000000900000410000000010000
009001000004000900000200300010020300000
008002100400420090000000010000102003000
008002040100000490002010000002000000010
009102000000010902000000004030000000000
009201000010400090020100000021000000300
009000000210000009044204000000200000010
011000000200224090000023000000210300000
109000000001040900202002000000210000000
112002100000402090000020010001020000000
108002040100000490004001000002000000100
112000100300204090000002100000210000000
110210040020002009000002100000010300000
112010000030004440900001000000210300000
113010000102000440904003000002200100010
112210300002000900400200000010002000100
109002410100002090020040000001000001000
113002100000042049000001000000210000000
110010200400010000902010200210010030000
113100000230000090400210000020002003000
109001000001044290000001000000210000010
111030020210004004900100100000210010000
112000400200040090000021000000002003000
112000100200000009040300200002000000300
112040040000000009000000200000010100100
113200200010040209000010200102002000100
113230010000420090000200010030000100100
114040010000040009000102000200102010000
113300020021000004904000100200200010010
112000000004100900200200010030002003000
113002210000040009000102000020102003000
112002010000020090004004100000200000010
113101000200210090040102000020002003000
112020104003000090400002010000000000000
113000200000010009040230000002002000100
113001000200210090020021000002210100000
111000210020024009000004100000210000000
111200000010020009004003000002000000300
112000210000004000900010200020010001000
113000010010020229004004100100200000010
109020100001024902000240200000010001000
112010300000020209000003000002210100000
110001000001010090240004002000200000010
113000000010104009020004200000010000300
113000200004000900000020104001020300000
112000210000004000900100200020010001000
111403000000040009000030000010210010000
113021010000420090000002010200102010000
114100210000044009000041000002000000010
115003000004102900000100210200020030000
114000002003000090400102010200020030000
114000200004010900002200100030020300000
114200210004004900000000100030020000000
114102000020100009024104400100000000010
113002100100020029004004100000200000010
114020010003002090200102010200300010000
116030000004210900002200100010200000000
114003000002000900400210000002010000300
114230000004210900042000400000000000010
111201002002100900020021000000210300000
114210100020020009004104100000200000010
116001010200240090004041000002100000010
117000010300104209020010200002010000300
115100010002004040900001000000210300000
116002102000020109000242104000000003000
117001020102000040904001000002200100010
116030042010000209000010102002000000300
116030000043004409020001000002210100000
216221040002000900002002100000210300000
216200100030042209000010002002100000010
217041004203000009020210000000210010000
216010300101040290200010000002300000100
219002102020020009000102410200000010000
215410100000402090000100010021020001000
216300000000210090002023000000210100000
217001000102010020904003000210200000010
217200010030004200900010200002010100100
220000210010040409000010002002100100010
216002300000104009020102200020010001000
216000040400000049002002100000210300000
217023000201042090200210000002300000000
216000100000100009040230000002200100010
219001010000024009000204100000210000000
215200010030040902000100400000010000000
219100104420040009000010200002010000100
217103000220042009000102000000300300000
215010000200000010904230020002200100010
218300200400010000902010200210010030000
216100300023002009020102000200300030000
218040100000042009000210002002100100010
215010010002102900400100010020020001000
220020010001020902004100100210200000010
216002300200102090200100010021020000000
218001000002420900000102010200102030000
216010104002200900000102210200000030000
218102100220024009000000400000010000000
217202000000300290204040000003000000300
217040104001040009000210200002010000100
215230000000210490002002100000210010000
217000210400040009000010200002010000100
218010210420040009000010002002100000300
217403000010024049000004100000210100000
215221002003000902040040002001000000300
219020010201040090200300002002100000010
219002002020100009020102400200010010000
217102100200300090204040000003000001010
215002010100104209020030000100210000000
218210010002102900400040010000020001000
217020040001000090200020010002100100000
215000410000040490000001000002102000100
219002300000020029004003000023000000010
218101020042000000904003000210200000010
217000010102004020900203000010210100000
217000000010040409002030000002210100000
219040210200040009000102000200102010000
216100010000204090000204100000210000000
217402100000402090000420010001020010000
220300200400010000902010200102010000300
216000000102000020904201020010200010010
217021000000420902000200010010102003000
218002100100024049000003000002000100010
216003004300040049000001000000210300000
220203002000000090400102010020020001000
217203004030040090200210000002300000100
218002100100000420904001020010200100010
220020040001000902000400102010200010010
219030002002420900000002010000102010000
219400210020040009002300000002010000010
318003000000210290002023000200210010000
319020002000100009040300200002002000100
320001010300220902000200104030000100000
320040004400040009000010000002210100010
319020010001020902000100104210200000000
319100002030040290000042002000100000300
320220010003004904000000100000210300000
319100042021000009000002010100200300000
318040100000042009000102000000102300000
318001010004102900200200010010020030000
319021040001000902004400100010200000010
322010040240000009000402102000200010010
320201010000420902000000010003002000100
318103002223000009020102000000300300000
319102000020300209024010000002100000300
321004010000100900020030004200000010100
318010204200000004900020100000210100000
318001010200240090002021000002300100000
318020000000210090020230004002100000000
318201000002040900200300002023000000000
319000102000240490000030002002100100010
320240100001042009000102000000102300000
318000300000210290002023000200210010000
318002010100022109000042104000000003000
320041010003004009020210000000210010000
319020100401020090204010000002100000300
322002102100040409000030000000210000000
318000200010040449000001002002100100010
318210420000000902002000100030020010000
318100040240000009002002100200210010000
320023000200210090020230004002100000000
320210210000004004900000100000210300000
319402100000402090000020010201020030000
320201000000210090040300200002002000100
319400100000402090000002010200102010000
320030000002210900020021002002100000010
319002100200204090000102200020010001000
318200100010042209000010000002102100000
319002100020024009000102100200300030000
318300200400010009020010200210010030000
321024102000220900000200300010200100000
319020100001042090200410000002102000000
320001000400210090020021000002210100000
318030000102010040904003000200200010010
319023000002210900002023000002010100000
320010210420040009000010000002300000000
318100040240000009002402100000210010000
318003002102040900004241000000200000010
320202100000022109000042104000000003000
319100010210040049000001000002210100000
320103000230024090200102000000300300000
318001010002224900000210100000020030000
320210300002020900200010010030000001000
319010300002210900002023000002010100000
318010210020020009002210100002300000000
321210300000000902200100010030002001000
322040004201000009000104200200010000300
322100000210400090000102010020020001000
321004100000210900020201002010200010010
326210242000000429002001000002000100010
