1405101300101220000101101401000101101401431101101531000310
1408101300220101101101000401000101401000431101000531310101
1402081000101431501000000101401310501000520000200000000000
1403101300330000111511111431401000111101401101210431000521
1404070900531431101000501431230511531431000101000101000320
1402051200501431430230101401401101431000000000530101310000
1406081100300000101000101000431511531210431520101100431101
1402050700300000431431101531000511210000431520101101431521
1404061100300000501101531000521101511431401401210431000101
1406111400501431230000531111431511000000000401431111431320
1401060900101501431300100101521101431401000000101531230000
1403091000000210101511000411000000101501401521320101000101
1405060900330000000000401531431220000511101401501530000521
1401091400501511431000500431000000401501521101200320431000
1405071400000401000000501401511511000401531310531000430230
1405061000000101000000501511501000000401431431200320431521
1404111200300531000000401101531511000401501431530101431230
1406131500100000000220000500521401000401000521330431000431
1406091000300000101101000401401000401431531101000531430230
1402041000501101511000400401401000000431401220320111531520
1402091400000521501101000501230300531400431401000000521000
1405091200431000101300000521521000401431431501501531230101
1408111200220431401000000000310101531501000401401520401101
1402041400501401430511431000000401401431401401200000401320
1404091000101511101000500230101300000430401511531531521000
1405061400101101101101511431401300501521431000200000531000
1401051500101531000300000501000401210521531511101431000521
1402091500501000501111111531431310401401210000431000521511
1409121500500230101000530000300101401511000401401530101521
1404081100300401101220431511531401401000431400531000000521
1406071300000501431310000501521511531401000401000530230000
1404051100210431000401501521101511000511000401320530000520
1403061100330000000431431101511000531510501521210521401401
1401101500000501401511320431401431531000511000210430430520
1406091200531000220000500101531431320511000511531401431521
1412141500500510400400000200501300401401000521531431431521
1402091300111431511000220000501320531531000511000521401401
1403051300101101220511300401530000431531401521000431000000
1404081400501000511000431431521200401401000431531310501000
1404101200501300401220401431401000000000500521531521000521
1402060700101000430310101431531511101501401000101100521200
1406101200501101101000431401430511000000501200531320000511
1406131500330000511431501401401000501000000230101531000521
1400041000501000401511431501000501320000521521101421200101
1401081500101431101300000000511401501401000000210521530521
1404060900101501330510501431401000401511531000000200000521
1401101300501511000101400320401101431000521501401531230101
1407121500000501000230330101511401000000401401401101531521
1410121400000431220511431401530000101000531520431000501310
1400121500431401431511501000000300000510000531531200401521
1409111400401000101531501101230000101531431511401330521431
1406070900100000000100431511511521501531531501320000431200
1408091100220431000000531511431431531501310401101000431520
1401121500521501511000501000320401401220000401531431000521
1400061400501000101101401000510101300000521220531401531521
1405060800000500511000501531521310401431431000531230000531
1401141500220401101511531000431101000521300401431000531521
1400020800431401431510501000431320511401000000531431200100
1402101300501101511220101330401401000000520521000530431000
1402111300501000511000320000431431101531220511401531521401
1402101100501000431531320220101511401000511401521531521401
1406081500431000000310501000430000531531210000401521521511
1402121300401431401220300431521000531401000000521501000101
1401081100501431511401401320000101501431511521200431000000
1409111300511000330511431210000511531531000401521401521401
1407091000500101431101401531401511200401511000000000330521
1401111300101511431511330531511511101431000521210431000000
1402041400401300431000501101531000431501431000200000521511
1400121500501511000000431000200300401401431000530401431520
1503111700000501430501000220401401000511401431000400300000531520000401101101531401521
1407111300511501000431000200000511431501401521531431431310
1408091000101511511000330531501000521501401000000000210521
1408101400000000300101200501401000401511401521501521531431
1404101100330431511000501000431000401431511401531431230521
1402131400401101510000101000501401431320401220000531401521
1400121400501431310000000500000000401531511511531000521200
1400060900431431101000501220401511000401401401531520401320
1404071500000000000220431501511401320401401000511501531521
1401071000101501430511000531000401101330531200101401511521
1504081800501511521000431000531431511000000000200000401000000501521000531511320431000
1402091400330000511101220521531431000401501511000000531521
1403111500000511300521531501000511401000431531210431431520
1401081500501511510521200000000000531101401300101401431521
1403041500501101000511400431000431401431220401320531521401
1405091200501000300220431401401401531401000000431431521520
1402071400000000501431401000531511320501521511000200431431
1405071200000501521511000501310521000000531431531210000431
1400101200431431000510501330511520401000431000531431431200
1400071300501000431431531431230511000300501401531521521000
1500111500501431310000000401000501220000401401401401401531401511000000000520531520000
1402111400000501501310000501521511000531210521000401531431
1405111200000511501401431501320000401431501511401531521200
1404121300000300000000401401401511401521501200401531101101
1407081300330101000431511401511521501000401000200531000000
1410141500000000431220300000401401531431401521000000531511
1400121500501431000310501400210000521401511000531431430521
1404111500501101101101431000511220000300000521401531531521
1406091400101101300101531000521511200501000000101511431531
1403101300000000101511220531521501531401401401101431521320
1502132100000431430431511501431310431400531501511431400000401401431400200530000000521
1400021300401000431511501000310521401401000431000531531230
1406131400500230511000530431531000401101531000000511431310
1400020700401501431401511401000511501431000531320000000200
1407111200501511500310000401401401000531521521531230000000
1402081300000000510101330401000101501501521000531521431230
1407091300300511521501000210431511000401531401000431401521
1404051400000000000310401431220521431501401531531431521511
1404071100220330000531531401511531431000511401401000431521
1406071400501000230431401000401521000501521310000531431501
1509122200101101210431511330431510401521501401520401000531431431521000000401431401000
1404091500501431101230431511000000531511431000531330431521
1406081200000431501310511501521101531401431101531000000230
1401041000501511501000511531521000200401431000330431521000
1406081400000531511401501401401431531431401230000431431310
1403101100000210431511300501431101531521431521101000000531
1401111200501431511000000000501511200000531521531000430310
1406070900501000000431320210431511431521401511101101531401
1409141500000401501230000401400000000501511531531310401521
1401050700220511000401401500521511530531501401000000000320
1502131900501431431101101401000101000000401000501431510531101401431521330521531000230
1402091000500430501511000401531521000401431310531230101101
1405091100000431000230531501510401431531511521000000330000
1401030700210531531511300431431511000000401401000000431521
1401031400501511511431200000000000000501521401330521521000
1405131500000000501511000401401300000000000401200531431521
1403061400531511330511501511531000401401401000000200521401
1411131500000501511220000531401401000401431401531431310521
1405071400501310521501000531431511210430000521000000431401
1401051200000501511531431431000000401501431521531310531230
1503091300500000000501511400000000531521400431431510000400431000401300200000431531521
1401020900501511501511501401401401400531521401320000000200
1403071500431000000501220000401511530520300401101531521401
1406121500210000431431000000510511501320401401531000000521
1403101100330431431511431000000431501431511521531101431200
1400101300501000511000431000401000000320521000401531501230
1401091300000431511401501401431521401401330000531431431230
1402061400101101511000330431501511000431000521000531431230
1401031500000501431511000401401401200101531300000101101521
1405091300401501431310401431501230531401000101431521000101
1506182000101501430510000330431521531401501000521000521401400531511000531000230431431
1400071300531531300000501431431511401000000520531431230101
1405060700000000000501220531431511531521401000000330431000
1401041300431511401101401501511000401000531310531431230000
1401101200431511501000501200401000300431521000531521101000
1401041000330511000000501431431401000000401521200431511531
1403131500101101511401501230330000000000401521401531431431
1406141500330431220401000501511521000000401401000000531521
1400011300501511000000401501401000101521220401101531521320
1404071200501431310101531511431401501230521000531431000000
1504132400501431510330511401531521000531401501000401000000431000101520401531230000431
1404061100431431430510501511521400531210401521330431431000
1401020600220431431300401531401521531000000521511000000501
1400061200501431501511400431531520000401401000531310000230
1408091400501431430230000511401511530531330521000000431431
1407131400511000210511330521000401500521000411530431521401
1403051400000000501511101431511401531501521200101531431310
1405121400501431511000210521511000000330401401531000521000
1403061000501431511431531310511000000210401000000531521401
1402041200501511401511501401000401320401000200531521000000
1503101400101431000531101501511000320101401220000531521531000431521511401000000431431
1400051500501511310511000401000501000401000200501401521531
1403051000000101501511501501431521200330521401000000431521
1412131500220511330000531000421511101000531521511531431401
1400011500501531431310220000000431400101431511531431401521
1401030900401501431511101501431000200521401000330521521101
1402141500000000501230000000531300531000431511431431431521
1405060900501431431000431501511000531531521320511000000230
1404091500501330511000401230431000101401401521000531431431
1406101500431000000101501000401300200401511401101531401521
1504061600000000431431511401501300431401401220531431521401531000431511531000431431521
1404091300330511000000431000431520501501431521531431430230
1400121400501000000511101320000521101501431220531521401000
1400070800501511431230531000511521531000330431401000431101
1406081000220101101300530511431400531501521401431521000000
1412131400300501431230401531511000401000521000531530511000
1403041500431511330511501531000000200401101000101501511521
1404060700501431230101531000431431000511531511000330521431
1406091000101531501511401431431401521431511320210000000101
1402041100000000521220501000511521531431000521330431000000
1500151800501101511000000501000431500520401200521401300401431431431101530000000000520
1510182300501310511000101431000000531101531431511401101210511000401401431000531520531
1500021800501000401000000401511401500310000401401000101200531431521101000000000000101
1502162200500430411000310400101501000431401401431000511101531401401200000511531521000
1510112100501000230101101000521000511501400501431431521401330430000000000531000000521
1507131900101101501101230101000401000000101501000431511000531431431520000320431520000
1513151600220500511101300401401000000000101101431401431531521531431521000000000000000
1510152200431000101101101431000000000511501000000501400501521401431520531310531230000
1508171900500431511101101200101531511401500511000000401320401531431521101000000000431
1510222300531511000000000501000000000300531511000511521101200401531431101101431431431
1507111700101511210501101000501401511000000401101101000000531401521000101521310531101
1502102200101300511000000101531401000220501431521501521531401000000101431431521000101
1500132000501511330510101000200101400101000401431521101401401101000000531501401521101
1502172100220501511401000401401401401000000000400000310400521521501101000531531101101
1511151700431000000000511401501300000401501521401531521531401431000101000431000230000
1511132400431401430430510000000501431521000501401531511531230000000401330431431000521
1508102300501000000000000531401431511401501310511431401000000000401101210521531521101
1500141800501431511000000401401000320000000431521431501401500520511401531520000200000
1506071200220501431511000000401431300401000000501521401000000000531401000531521431521
1506071100330431431511000501401400401000521401101501510000220401531520000531521000000
1505081900210511000000101401000511510000101531401000000101101401000431101101531531310
1503122300500430431431310400000101431000000000531431431000000220431511531000000521401
1510111900101300000000220501520431511401531531431431401101000521401521101431501000431
1501062400000501431431431000531401210000101000000000000101000511511511330431531521521
1501041900500501511000511400000000401401400531431401320530000000521511000431431431200
1519232400000101101101101000000500430310500401531511401000000521401401200401000531521
1506161900101511511401000000501200401000300401531511000401521501521401531000000431521
1504050600431431501431511501531000511320401401400401401000000431531220000000000521521
1506111700000000330510101501401000501101200511401521531401401531401101000000521531101
1505111900431501000101101501401430430510401531330511401431431401521401000000000000200
1512131400210430000401000431511101401511431531501521511101000401000000101000531431310
1504102000101101431531511220330430000101531000431521401401000101501511531511000521101
1501091000500510101101101401000300501511400431401000000401531401000401531431521521200
1501042100000511501431511511531521330521431000000000000401501000401101531531431230101
1513162400101500000230000101530000000401431431431511501501401300521000531431101431521
1502072100101511501431511531531431000200501000400501101000401521000101101531431431310
1504050800101401000501511501431431521401000000000401401330520511200401101000531431521
1502082200501401430431310401000501511401000101501521401000000200101000401530410521101
1500222300501431521000101401000000501101401000000000000531511000220101330531521521101
1503232400000431000510000501330000401431401431431401511200401501521000101101531521431
1501071100101501000511101511000431000501210521101401310401431521531000101101101000101
1501081100431501230300101401531101511401000501101521401400531000000521530431431431101
1500042200501431431431511000501431431401000431511400000531000300401200000531521000521
1507111300101101101000000330430431511000431501521501000220521401401000530431521101101
1506151700101101101101000431431000000000401501501401000501310401521431531431521200511
1509111400500430000431220000000401511521000531431511531101101401531521101101531310101
1520212200000101000000101501431431511401431531101511000330000431200000531511521000401
1511171900000431521300101500431000401220000501431521401000531431501521000430431521431
1508121800401500000000000401431401401401000511511000000210520000401401330431431520000
1404091100101000431230401401431531501501000511401521000320
1506071200000230000000510000501511310400501531401431520531501401431000401531521431000
1504101400431430430510401000521501521401501511220000431000401531521000100330000000520
1500152000501401000431000401521501000000501000320521220431511000000521530431000401431
1505152400511000431000501521401431401531000000431000000511000210000511521000000330521
1500022100401220401500510000521431531000000000000431521511431501000000320401530000000
1504131700000501000101401000531310000531000400220431000531000501511401000530430521431
1500042000431501000431431500000000000401521401000000510320220000000521431401531511531
1500202400431401330000511000531511000431000531230000501000101431401401401431430531521
1511172300210431431431511501521100000401401501511000401531521401100401000000320431521
1511152300501401101230000431101431300000401431500431401400101000101521531101000401101
1500171900500511330431531501401000511000401401401521501401401511000420200530431431521